1111111111111111
1000000100000001
1000000100000001
1001000100000001
1001000100000001
1001000100000001
1001000100010001
1001000100010001
1001000100010001
1001000000010001
1001000000010001
1111111111111111
